* Acidic: A wine with a noticeable sense of acidity.[2] It's detected by the mouth watering sensation. [3]
* Aftertaste: The taste left on the palate after wine has been swallowed. "Finish" is a synonym.[4]
* Alcoholic: A wine that has an unbalanced presence of too much alcohol.[4]
* Aroma: The smell of a wine. The term is generally applied to younger wines, while bouquet is reserved for more aged wines.[5]
* Astringent: An overly tannic white wine.[6]
* Autolytic: Aroma of "yeasty" or acacia-like floweriness commonly associated with wines that have been aged sur lie.[5]
* Baked: A wine with a high alcohol content that gives the perception of stewed or baked fruit flavors. May indicate a wine from grapes that were exposed to the heat of the sun after harvesting.[5]
* Balanced: A wine that incorporates all its main components—tannins, acid, sweetness, and alcohol—in a manner where no one single component stands out.[7][3]
* Big: A wine with intense flavor, or high in alcohol.[8][9]
* Bitter: An unpleasant perception of tannins.[9]
* Body: The sense of alcohol in the wine and the sense of feeling in the mouth.[6] A wine is usually described as light, medium or full body.[3]
* Bouquet (/bu??ke?/, French: [bu.k?]): The layers of smells and aromas perceived in a wine.[6]
* Brilliance: When describing the visual appearance of the wine, it refers to high clarity, very low levels of suspended solids. When describing fruit flavors, it refers to noticeable acidity and vivid intensity.[9]
* Buttery: A wine that has gone through malolactic fermentation and has a rich, creamy mouthfeel with flavors reminiscent of butter.[10]
* Chewy: The sense of tannins that is not overwhelming. It is not necessarily a negative attribute for wine.[6][10]
* Chocolaty: The flavors and mouthfeel associated with chocolate, typically among rich red wines such as Cabernet Sauvignon and Pinot noir.
* Closed: A wine that is not very aromatic.[6][10]
* Cloying: A wine with a sticky or sickly sweet character that is not balanced with acidity.[11]
* Coarse: A wine with a rough texture or mouthfeel. Usually applies the perception of tannins.[11]
* Complex: A wine that gives a perception of being multi-layered in terms of flavors and aromas.[11]
* Concentrated: Intense flavors.[6]
* Connected: A sense of the wine's ability to relay its place of origin or terroir.[12]
* Corked: A wine that has cork taint.[11]
* Crisp: A pleasing sense of acidity in the wine.[8]
* Depth: A wine with several layers of flavor. An aspect of complexity.[11]
* Dirty: A wine with off flavors and aromas that most likely resulted from poor hygiene during the fermentation or bottling process.[11]
* Dry: A wine that is lacking the perception of sweetness.[2][13]
* Earthy: This can mean a wine with aromas and flavor reminiscent of earth, such as forest floor or mushrooms. It can also refer to the drying impression felt on the palate caused by high levels of geosminthat occur naturally in grapes.[13]
* Elegant: A wine that possess finesse with subtle flavors that are in balance.[13]
* Expressive: A wine with clearly projected aromas and flavors.[14]
* Extracted: A wine with concentrated flavors, often from extended skin contact, trading a rougher youth for enhanced ageability.[13]
* Fallen over: A wine that, at a relatively young age, has already gone past its peak (or optimal) drinking period and is rapidly declining in quality is said to have "fallen over".
* Fat: A wine that is full in body and has a sense of viscosity.[8] A wine with too much fat that is not balanced by acidity is said to be "flabby"[13] or "blowzy"[citation needed]
* Finesse: A wine of high quality that is well balanced.[13]
* Finish: The sense and perception of the wine after swallowing.[8]
* Firm: A stronger sense of tannins.[6]
* Flabby: A lacking sense of acidity.[8][13]
* Flat: In relation to sparkling wines, flat refers to a wine that has lost its effervescence. In all other wines the term is used interchangeably with flabby to denote a wine that is lacking acidity, particularly on the finish.[15]
* Foxy: The musty odor and flavor of wines made from Vitis labrusca grapes native to North America, usually something undesirable.[16][15]
* Fresh: A positive perception of acidity.[6]
* Fruit: The perception of the grape characteristics and sense of body that is unique to the varietal.[6][15]
* Full: Wine with heavy weight or body, due to its alcohol content. It can also refer to a wine that is full in flavor and extract.[15]
* Grassy: An herbaceous or vegetal element of a wine—ranging from freshly mown lawn grass to lemon grass flavors.[15]
* Green: Usually negative, this can apply to a white wine with vegetal notes, or a red wine with bell pepper or herbal notes. Typically used to describe a wine made from unripe fruit.[8][15]
* Hard: Overly tannic wine.[6]
* Heavy: A wine that is very alcoholic with too much sense of body.[8]
* Herbal: A wine with a flavour or aroma "reminiscent of herbs".[15]
* Herbaceous: The herbal, vegetal aromas and flavors that maybe derived from varietal characteristics or decisions made in the winemaking process-such as harvesting under-ripened grapes or using aggressive extraction techniques for a red wine fermented in stainless steel.
* Hollow: A wine lacking the sense of fruit.[6]
* Hot: Overly alcoholic wine.[8][15]
* Jammy: A wine that is rich in fruit but maybe lacking in tannins.[17]
* Lean: The sense of acidity in the wine that lacks a perception of fruit.[6]
* Leathery: A red wine high in tannins, with a thick and soft taste.[18]
* Legs: The tracks of liquid that cling to the sides of a glass after the contents have been swirled. Often said to be related to the alcohol or glycerol content of a wine. Also called tears.[17]
* Musty: A wine with a "dank, old-attic smell" arising from processing moldy grapes or using dirty storage containers.[17]
* Nose: The aroma, smell or bouquet of a wine.[19]
* Oaky: A wine with a noticeable perception of the effects of oak. This can include the sense of vanilla, sweet spices like nutmeg, a creamy body and a smoky or toasted flavor.[2][19][3]
* Oxidized: A wine that has experienced too much exposure to oxidation, considered faulty, and may exhibit sherry-like odors.[19]
* Oxidative: A wine that has experienced constrained exposure to oxidation over the course of its aging process.[19] The aromas and flavors that develop as a wine oxidatively matures can range from nuttiness, biscuity and butteriness to more spicy notes.
* Petrolly: A wine containing a high concentration of trimethyldihydronaphthalene, whose scent is evocative of the odour of petrol, kerosene or paraffin. A petrolly character is considered a highly desirable characteristic in mature Rieslings.[20]
* Powerful: A wine with a high level of alcohol that is not excessively alcoholic.[6]
* Raisiny: A wine (usually red) with a slight taste of raisins resulting from the use of grapes that were overripe when picked.[21]
* Reticent: A wine that is not exhibiting much aroma or bouquet characteristics perhaps due to its youth. It can be described as the sense that a wine is "holding back".
* Rich: A sense of sweetness in the wine that is not excessive.[6]
* Rough: A wine with coarse texture, usually a young tannic wine.[22]
* Round: A wine that has a good sense of body that is not overly tannic.[6]
* Smokey: A wine exhibiting the aromas and flavors of the various types of smoke, such as tobacco smoke, roasting fire smoke and a toasty smoke derived from oak influences.[22]
* Smooth: A wine with a pleasing texture. Typically refers to a wine with soft tannins.[8]
* Soft: A wine that is not overly tannic.[6]
* Sour: A wine with unbalanced, puckery acidity. Often applies to mistreated wines with excessive acetic acid, giving a vinegar-like bite.[22]
* Spicy: A wine with aromas and flavors reminiscent of various spices such as black pepper and cinnamon. While this can be a characteristic of the grape varietal, many spicy notes are imparted from oak influences.[22]
* Supple: A wine that is not overly tannic.[6]
* Sweet: A wine with a noticeable sense of sugar levels (aka Residual sugar).[2][3]
* Tannic: A wine with aggressive tannins.[2][23] It's detected by the drying sensation felt on the teeth, gums, tongue and inner cheeks. It comes from the skin, seeds and stems of grapes. Think of drinking dark black tea without any milk or sugar.[3]
* Tar: A wine with aromas and flavors reminiscent of Tar. Barolo and Amarone wines often exhibit such characteristic.
* Tart: A wine with high levels of acidity.[6] Tartness or acidity is detected by the mouth watering sensation.[3]
* Toasty: A sense of the charred or smoky taste from an oaked wine.[2][23]
* Transparency: The ability of a wine to clearly portray all unique aspects of its flavor—fruit, floral, and mineral notes. The opposite would be a wine where flavors are diffused and thoroughly integrated.[24]
* Typicity: How much a wine expresses the typical characteristics of the varietal.[23]
* Vanillin: An oak induced characteristic aroma reminiscent of vanilla.[25]
* Vegetal: A wine with aromas and flavor reminiscent of vegetation as opposed to fruit or floral notes.[25]
* Vinegary: A wine with "the harsh aroma of vinegar" usually resulting from the presence of acetic acid.[25]

